Osteria della Madonna da Peo	Via dei Liguri 28 
La Korte dei Sapori Persi	Piazza Borgo Calvenzano 1
Osteria alle Carceri	Via Fratelli Marozzi 7
I Tagliati Ristorante	Corso Str. Nuova 75
Locanda del Carmine	Piazza del Carmine 7/A
La Torre degli Aquila	Corso Str. Nuova 20
Ristorante Bardelli	Lungo Ticino Visconti 2
Antica Trattoria Ferrari	Via dei Mille 111
Ristorante Piedigrotta	Piazza Petrarca 40
Osteria della Malora	Via Milazzo 79
Il Jumbo	Via Lanfranco 14/12
Diablo Steak House	Piazzale Ponte Ticino 6
Pizzeria Ristorante Bella Napoli	Piazza della Vittoria 10
Osteria il Senatore	Corso Giuseppe Mazzini 8
Taverna Santorini	Via del Carmine 4
Pane Salame	Corso Carlo Alberto 72
Leo’s Piada	Corso Str. Nuova 10
La Nuova Toscana	Via Cardano 6
Ristorante Pizzeria Marechiaro di Beniamino Mandara	Piazza della Vittoria 9
Le Tre Torri Restaurant	Via Lazzaro Spallanzani 6
